111111111111111
1C0001E100000C1
100100010000CC1
100011110000001
100000000000001
101000C001C0001
101000001P10001
1C1000000000001
111111111111111
