111111111111111
1C0010001C001E1
101010101010101
101010101010101
101010101010101
101010101010101
101010101010101
1P10C0100010001
111111111111111
